1111111111111111
1000111001110001
1001C00110001001
1010000000000101
1010000000000101
1010000000000101
1001000PE0001001
1001000000001001
1000100000010001
1000011CC1100001
1000000110000001
10000000000000 1
1111111111111111
1111111111111111
1111111111111111
1111111111111111