1111111111111111111111111111111111111111
1P10000000001000000000000101000100000001
1010111011101111101111110101010111110101
1010100010100000001001000000010000010101
1010101110111110110000111111011111010101
1000000010100000100110000000010001010101
1011111010101111101111111111010101011101
1010100010001000101000010000000101010001
1010101011111100101001010111011111010101
1000101010000001101001010101010000010101
1011101010111111001011010101010111110101
1010001010100000001001010101010000000101
1010111010111111001111010001011111111101
1010101010001000011000011001000000000101
1110101011100011110011111101001111111101
1000101010100110000001000001100000000001
1011100010111111111101011111111101111111
1000101110000010000001011000000100000001
1110101110111010111101001101110100111101
1001100010001010000011100001000110000101
1000011001101000000010000001000000010101
1000111100101111001100111101111111010101
1010000000100111101001100100011001010101
1011101011110010101011110100110001010111
1000101C000110000000000001000001000000E1
1111111111111111111111111111111111111111