111111111111111
1OCCCCCPCCCCCK1
1C111CC1CC111C1
1CCC11C1C11CCC1
1C1111C1C1111C1
1C1C1CC1CC1C1C1
1RCCCCCECCCCCB1
111111111111111