111111111111111111111111111
100000000000000000000000001
101111111111111111111111101
101111111111111111111111101
1011111111111000P1111111101
100000000000000111111111101
111111111111111111111111101
1000100010001O0C11111111101
101110101011101011111111101
1R111B001K11100011111111101
1000101010001E10000000000C1
111111111111111111111111111