1111
1PE1
1001
1001
1001
1001
1001
1C01
1111
