111111111111111111111111111
100000000000000000000000001
101111111111111111111111101
101111111111111111111111101
10111111111110C0P1111111101
100000000000000111111111101
111111111111111111111111101
100010001000100011111111101
101110101011101C11111111101
101110001011100011111111101
1000101010001E1000000000001
111111111111111111111111111