11111111111111111111
1000000P0100E001C001
10000C00C000C0100001
10100000CC1C00000001
100000000C00000C0001
1000C001100000000001
1000C0000CCC1000C001
10101C000001000000C1
10010000000C00000001
10000000000000000001
10010000000000001001
10000000000000000001
1000000000000000C001
10000100000010000001
1000C1000C0000001001
1100000000C000C00001
10001C0000C0000000C1
10000000100000000011
100C0000C00000000C01
11111111111111111111
