111111111111111111111
1E0000000000000000CC1
1000000000000000000C1
100110011000111110001
100110011000000011001
100110011000000011001
100111111000011110001
100011111000110000001
100000011000110000001
100000011000111111001
1C00000000000000000C1
1PC000000000000000CC1
111111111111111111111