1111111111111111
1000111001110001
1001000110001001
1010000000000101
1010000000000101
1010000000000101
1001000PE0001001
1001000000001001
1000100000010001
1000011CC1100001
1000000110000001
1000000000000001
1111111111111111
1111111111111111
1111111111111111
1111111111111111